3,3,3,3,3,3,3,3,3,3,3,3,3,3,3,3,3,3,3,3,3,3,3,3,3,3,3,3,3,3,
3,3,3,3,3,3,3,3,3,3,3,3,3,3,3,3,3,3,3,3,3,3,3,3,3,3,3,3,3,3,
3,3,3,3,3,3,3,3,3,3,3,3,3,3,3,3,3,3,3,3,3,3,3,3,3,3,3,3,3,3,
3,3,3,6,6,6,6,6,6,6,6,6,6,6,6,6,6,6,6,6,6,6,6,6,6,6,6,3,3,3,
3,3,3,6,7,7,7,7,7,7,7,7,7,7,7,7,7,7,7,7,7,7,7,7,7,7,6,3,3,3,
3,3,3,6,7,6,6,5,5,6,6,6,6,6,6,6,6,6,6,6,6,6,6,6,6,7,6,3,3,3,
3,3,3,6,7,6,5,5,5,5,6,6,6,6,6,6,6,6,6,6,6,6,6,6,6,7,6,3,3,3,
3,3,3,6,7,5,5,5,5,5,5,7,7,7,7,7,7,7,7,7,7,7,6,6,6,7,6,3,3,3,
3,3,3,6,7,5,5,5,5,5,5,7,7,7,7,7,7,7,7,7,7,7,6,6,6,7,6,3,3,3,
3,3,3,6,7,6,5,5,5,5,6,7,7,7,7,7,7,7,7,7,7,7,6,6,6,7,6,3,3,3,
3,3,3,6,7,6,6,5,5,6,6,7,7,7,7,7,7,7,7,7,7,7,6,6,6,7,6,3,3,3,
3,3,3,6,4,4,4,4,4,4,4,4,4,4,4,4,4,4,4,4,4,4,4,4,4,4,6,3,3,3,
3,3,3,6,4,6,6,6,6,6,6,6,6,6,6,6,6,6,6,6,6,6,6,6,6,4,6,3,3,3,
3,3,3,6,4,6,6,6,6,6,6,6,6,6,6,6,6,6,6,6,6,6,6,6,6,4,6,3,3,3,
3,3,3,6,4,6,6,6,6,6,6,6,6,6,6,6,6,6,6,6,6,6,6,6,6,4,6,3,3,3,
3,3,3,6,4,6,6,6,6,6,6,6,6,6,6,6,6,6,6,6,6,6,6,6,6,4,6,3,3,3,
3,3,3,6,4,6,6,6,6,6,6,6,6,6,6,6,6,6,6,6,6,6,6,6,6,4,6,3,3,3,
3,3,3,6,4,6,6,6,6,6,6,6,6,6,6,6,6,6,6,6,6,6,6,6,6,4,6,3,3,3,
3,3,3,6,4,4,4,4,4,4,4,4,4,4,4,4,6,6,4,4,4,4,4,4,4,4,6,3,3,3,
3,3,3,6,6,6,6,6,6,6,6,6,6,6,6,6,2,2,6,6,6,6,6,6,6,6,6,3,3,3,
3,3,3,6,6,6,6,6,6,6,6,6,6,6,6,6,2,2,6,6,6,6,6,6,6,6,3,3,3,3,
3,3,3,6,6,6,6,6,6,6,6,6,6,6,6,6,2,2,6,6,6,6,6,6,6,3,3,3,3,3,
3,3,3,3,6,6,6,6,6,6,6,6,6,6,6,6,2,2,6,6,6,6,6,6,3,3,3,3,3,3,
3,3,3,3,3,6,6,6,6,6,6,6,6,6,6,6,2,2,6,6,6,6,6,3,3,3,3,3,3,3,
3,3,3,3,3,3,6,6,6,6,6,6,6,6,6,6,2,2,6,6,6,6,3,3,3,3,3,3,3,3,
3,3,3,3,3,3,3,6,6,6,6,6,2,2,2,2,2,2,6,6,6,3,3,3,3,3,3,3,3,3,
3,3,3,3,3,3,3,3,6,6,6,6,2,2,2,2,2,2,6,6,3,3,3,3,3,3,3,3,3,3,
3,3,3,3,3,3,3,3,3,6,6,6,2,2,6,6,6,6,6,3,3,3,3,3,3,3,3,3,3,3,
3,3,3,3,3,3,3,3,3,3,6,6,2,2,6,6,6,6,3,3,3,3,3,3,3,3,3,3,3,3,
3,3,3,3,3,3,3,3,3,3,3,6,5,5,6,6,6,3,3,3,3,3,3,3,3,3,3,3,3,3