11,11,11,11,11,11,11,11,
11,11,11,11,11,11,11,11,
11,11,11,11,11,11,11,11,
11,11,11,11,11,11,11,11,
11,11,11,11,11,10,11,11,
11,11,11,0,11,11,11,11,
10,11,11,11,11,11,11,11,
11,11,11,11,11,11,11,11